#include <stdio.h>

#define MAXSTAGE 5
#define putchxy(x,y,c),{gotoxy(x,y); putch(c);}
 





void sokStage()
{
	int putchxy;
	int stagex, stagey;
	
	for (stagey = 0; stagey < 10; stagey++)
	{
		for (stagex = 0; stagex < 34; stagex++)
		{
			putchxy(stagex,stagey,stage[stagey][stagex]);
		}
	}
}
    int Movecode;
	int Movex,Movey;
	
	char arStag[MAXSTAGE][10][34]={
		 {
		  "#############",
		  "########  ####",
		  "##o      #####",
		  "##       ####",
		  "##       ##",
		  "####      ##",
		  "######     *##",
		  "###  ¤  ##",
		  "###       ###",
		  "############"

		 },
		 { 
		  "##########",
		  "###    o ##",
		  "###    o ###",
		  "##       ###",
		  "####    # #",
		  "##  ¤¤  #",
		  "##  ##   #",
		  "##   *  ###",
		  "###    ####",
		 "###########"
		 },
		 { 
		  "################",
		  "################",
		  "####o##oo#######",
		  "##         #  #####",
		  "##   # ¤     #######",
		  "##   ¤ ¤  #######",
		  "##*   ##   ######",
		  "##      #######",
		  "################",
		  "################"
	  },	
		 {
		  "###################",
		  "####           #####",
		  "#######      #####",
		  "#o#o#  ¤¤  ######",
		  "# o o      # ######",
		  "#       ##   ####",
		  "# # #  ¤ ¤ ######",
		  "# ## *     #########",
		  "#####    ########",
		  "#################"
	  },
		 { 
		  "#############################",
		  "#########################",
		  "############o o o     ##",
		  "######         ###########",
		  "###    #####      o####",
		  "##  ¤      #############",
		  "##   #   ¤ #############",
		  "## #  #   #      o#######",
		  "### ¤  ¤   #############",
		  "## * # ¤    #############",
		  "## #      ##############",
		  "#########################"
	      }	
		};

	return;
}
